{
  "special": "snow",
  "width" : 106,
  "height" : 15,
  "scale" : 
    "0....:....1....:....2....:....3....:....4....:....5....:....6....:....7....:....8....:....9....:....0....:",
  "map" : [
    "*.........************************************************************........*****........¥¥......+.....*",
    "*.........*****************....u...u....*****************************∆........*****!#..|.....¥.....+.....*",
    "*.¥..$..A.†****************.............******************************....L1..*****!#..@...........+.....*",
    "*.¥..¬¬¬¬¬**************...................***************************........*****¬¬¬¬¬¬¬.........+.....*",
    "*.¥..*******************...................***************************....---]************.........+.}1..*",
    "*...................................................+..+..+......**................................+.....*",
    "*...................¥....f.....¥.¥.¥................¢..◊..+...¥..**..............¥¥...¥¥...........+.....*",
    "*.........w.....w..¥.¥..............................+..+..+..¥?¥.**............................W...◊.}0..*",
    "*............w......¥...........................W...+..+..+...¥..................^^...^^...........+.....*",
    "*...................................................◊..+..+......................¬¬...¬¬...........+.....*",
    "*æ5.................................................+..+..+......................**...**...........+.....*",
    "*.............................¥.¥.¥.¥...............+..¢..◊......................**.¥.**...........+.....*",
    "*Æ5.................................................+..+..+......................**...**...........+.....*",
    "*^^^^^^^^^^^^^^^^^^^^^^^^^^^^^^^^^^^^^^^^^^^^^......+..+..+.................^^^^^**...**^^^^^......+.....*",
    "*¬¬¬¬¬¬¬¬¬¬¬¬¬¬¬¬¬¬¬¬¬¬¬¬¬¬¬¬¬¬¬¬¬¬¬¬¬¬¬¬¬¬¬¬¬......+..+..+.................¬¬¬¬¬**...**¬¬¬¬¬......+.....*"
  ],
  "next" : [
    { "level": "3-Boss", "start": "A" },
    { "level": "3-A", "start": "A" }
  ]
}