{
  "special": "boss",
  "width" : 40,
  "height" : 15,
  "scale" : 
    "0....5....0....5....",
  "map" : [
    "........********##***..................*",
    "................##***..................*",
    ".........W..........;..................*",
    "..........w.........;......V...........*",
    "....◊++++...b....A..;..................*",
    "........+...è...¬¬¬¬¬..................*",
    "+++++++++...........*..................*",
    "+...........}0....b.*..................*",
    "++++++...........b..*....--......--....*",
    "..+++++.....}2......*..................*",
    "..++++++............*..--..........--..*",
    ".....+++....}0......*..................*",
    ".....+++◊...........*+^^^^^++++++^^^^^+*",
    "¬¬¬¬..¡¡¡¡¡¡¡¡¡¡¡¡¡¡*¬¬¬¬¬¬¬¬¬¬¬¬¬¬¬¬¬¬*",
    "****..¬¬¬¬¬¬¬¬¬¬¬¬¬¬********************"
  ],
  "next" : [
    { "level": "1-Boss", "start": "A" }
  ]
}