{
  "special": "boss",
  "width" : 40,
  "height" : 15,
  "scale" : 
    "0....5....0....5....",
  "map" : [
    "........********##***..................*",
    "................##***..................*",
    ".........W..........;..................*",
    "..........w.........;......V...........*",
    "....◊++++........A..;..................*",
    "........+.......¬¬¬¬¬..................*",
    "+++++++++...........*..................*",
    "+...........}0......*..................*",
    "++++++......}1......*....--......--....*",
    "..+++++.....}2......*..................*",
    "..++++++...+}3+.....*..--..........--..*",
    ".....+++............*..................*",
    ".....+++◊...........*+^^^^^++++++^^^^^+*",
    "¬¬¬¬..¡¡¡¡¡¡¡¡¡¡¡¡¡¡*¬¬¬¬¬¬¬¬¬¬¬¬¬¬¬¬¬¬*",
    "****..¬¬¬¬¬¬¬¬¬¬¬¬¬¬********************"
  ],
  "next" : [
    { "level": "1-Boss", "start": "A" }
  ]
}