{
  "special": "none",
  "width" : 139,
  "height" : 15,
  "scale" : 
    "0....*....@....*....@....*....@....*....@....*....5....*....@....*....@....*....@....*....@....*....0....*....@....*....@....*....@....*",
  "map" : [
    "•••©......©•••••••••••••••••••••••••••••••••••••••••••••••••••••••••©......©•••••©.....................................................©•••",
    "•••©......©•••©©©••••••••••••••••••••••••••••••••••••••••••••••©©©©©©......©•••••©............................................X........©•••",
    "•••©......©•••©¶©•••••••••••••••••••©©©©©©©©©©©©©©©©©©©••••••••©...........©©©©©•©.................¥¥¥.................................©•••",
    "•••©......©©••©©©•••••••••••••••••••©.................©©©©©©©©©©...............©•©..............¥¥..........................©©©©©©.....©•••",
    "•••©.......©©•••••••••••••••©©©©©©©©©........................√.................©•©........................+.................©¶¶¶¶©.....©•••",
    "•••©........©©©©©©©©©©©©©©©©©................................√.................©©©..........¥.............+............-]©©©©©©©©©.....©•••",
    "•••©..|...............√................¥¥¥...................+...........++................+++............+..............©•••••••©.....©•••",
    "•••©..@.A.............√.............¥¥.......................+...........++++..............+++............+..............©•••••••©.....©•••",
    "•••©©©©©©©©©©>>>©©©©©©+............................++++......++++++++++++++++++++++++++++++++++++++++++++++..............©•••••••©.....©•••",
    "••••••••••••©©©©©••••©+...................+++++++++++++..................................................................©•••••••©.....©•••",
    "•••••••••••••••••••••©+++++++++++++++++++++++++++++++++..................................................................©©©©©©©©©.....©•••",
    "•••©©©•••••••••••••••©..............................................................................................................|..©•••",
    "•••©¶©•••••••••••••••©..............................................................................................................@..©•••",
    "•••©©©•••••••••••••••©©©©©>©©©©©©©©©©©©©©>©©©©©©©©©©©©©©>©©©©©©©©©©©©©>©©©©©©©©©©©©©©>©©©©©©©©©©©©©©>©©©©©©©©©©©©©©>©©©©©©©©©©©©©©©©©©©©•••",
    "•••••••••••••••••••••••••©©©••••••••••••©©©••••••••••••©©©•••••••••••©©©••••••••••••©©©••••••••••••©©©••••••••••••©©©••••••••••••••••••••••"
  ],
  "next" : [
    { "level": "4-4", "start": "B" },
    { "level": "4-4", "start": "B" }
  ]
}