{
  "width" : 20,
  "height" : 15,
  "scale" : 
    "0....5....0....5....",
  "map" : [
    "*..................*",
    "*.......%%%%[-----]*",
    "*.|.....****..¥¥¥..*",
    "*.@A.+..****..¥¥¥..*",
    "*%%%%%..****......+*",
    "******..****[%%%%%%*",
    "******...^^^#*******",
    "******...%%%.......*",
    "******...***[%%%...*",
    "******....^^#***...*",
    "*...**....%%.......*",
    "*...**....**[......*",
    "*.|................*",
    "*.@................*",
    "*%%%%%%%%%%%%%%%%%%*"
    
    
  ],
  "next" : [
    { "level": "1-A", "start": "A" },
    { "level": "1-1", "start": "B" }
  ]
}