{
  "special": "none",
  "width" : 108,
  "height" : 15,
  "scale" : 
    "0....*....1....*....2....*....3....*....4....*....5....*....6....*....7....*....8....*....9....*....0....*..",
  "map" : [
    "...........................**.............................................**.......................+++++++++",
    "...........................**.à.........................................?.**.......................+++++++++",
    "...........................**..........f1...........................f1..?.**.......................+++++++++",
    "...........................**¬¬¬[.........................¥¥¥.............**.......................+++++++++",
    "...........................*****.....................P....===..........¬¬¬**.......................+++++++++",
    "...........................+++......==....==.........¡¡................*****.......................++++¢++++",
    ".......................W..◊+++.................==....¡¡.........===....*****...........Wf..........++++¢++++",
    "...........W...............+++.........¥¥..............................*****............W.........◊++++¢++++",
    "....................P......+++...w.....==............S.................+++++....................¬¬¬+++++++++",
    "..A............S..¬¬¬[.....¢¢¢............w...¡¡¡¡...¥¥................+¢+¢+...................¬***+++++++++",
    "¬¬¬¬¬..¥¥¥........***......¬¬¬..........S............¥¥......?.........++¢++.....¬¬¬[.........¬****+++.|.+++",
    "*****¡¡¡¡¡¡¡¡¡¡¡¡¡***....^^***¡¡¡¡¡................¡¡¡¡¡¡..............+¢+¢+....¬***.......]¬¬*****+++.@.+++",
    "*****¬¬¬¬¬¬¬¬¬¬¬¬¬***....¬¬***¡¡¡¡¡¡¡¡¡¡¡¡¡........¡¡¡¡¡¡...¡¡¡......º◊+++++...¬****........*******+++¬¬¬+++",
    "*********************....*****¡¡¡¡¡¡¡¡¡¡¡¡¡^^......¡¡¡¡¡¡...¡¡¡....¬¬¬¬¬¬¬¬¬¬¬¬*****...¡....*******+++++++++",
    "*********************....*****¬¬¬¬¬¬¬¬¬¬¬¬¬¬¬......¬¬¬¬¬¬...¬¬¬....*****************...¬....*******+++++++++"
  ],
  "next" : [
    { "level": "3-2", "start": "A" }
  ]
}