{
  "special": "none",
  "width" : 69,
  "height" : 15,
  "scale" : 
    "0....-....1....-....2....-....3....-....4....-....5....-....6....-....7....-....8....-....9....-....0...",
  "map" : [
    "***************&&&&+++++++++++&&&&&&&&&&&&&&&&&&&&&................&&",
    "**************&&&&&+&&&&&&&&&+&&&&&&&&&&&&&&&&&&&&&................&&",
    "*************&&&..◊◊◊......+.+.◊........&&&&&&&&&&&................&&",
    "**....******&&&............+.+.◊........&&&&&&&&&&&................&&",
    "**.....*****&&&............+.+.+........&&&&&&&&&&&................&&",
    "**.|........+++............+.+.+........&&&&&&&&&&&................&&",
    "**.@.B......+++............+.+.+........&&&&&&&&&&&....¥¥¥¥¥¥¥¥....&&",
    "**¬¬¬¬¬.....++◊....f.......+.+.+........&&&&&&&&&&&....¥¥¥¥¥¥¥¥....&&",
    "**..........+++........---.+.+.+...Y....&&&&&&&&&&&................&&",
    "**..........+++............+.+.+..?..?..&&&&&&&&&&&...O..O..O..O...&&",
    "**.....¬¬¬¬¬///............+.+.+........&&&&&&&&&&&-//////////////.&&",
    "**.A..¬*****&&&/++++++◊+++++.+.+........&&&&&&&&&&&.&&&&&&&&&&&&.|.&&",
    "**¬¬¬¬*******&&&/............+.+........º...........&&&&&&&&&&&&.@.&&",
    "**************&&&///////////////////////////////////&&&&&&&&&&&&///&&",
    "***************&&&&&&&&&&&&&&&&&&&&&&&&&&&&&&&&&&&&&&&&&&&&&&&&&&&&&&"
  ],
  "next" : [
    { "level": "3-Boss", "start": "A" },
    { "level": "3-Boss", "start": "B" }
  ]
}