{
  "special": "none",
  "width" : 40,
  "height" : 15,
  "scale" : 
    "0....5....0....5....",
  "map" : [
    "........&&&&&&&&&&&&&&&&&&&&&&&&&&&&&&&&",
    "........&&&&&&&&##&&&&&&&&&&&&&&&&&&&&&&",
    "................##&&&&&&&&&&&&&&&&&&&&&&",
    "........................................",
    "..........L.............................",
    "........................................",
    "..........{.............................",
    ".....{..................≤≤≤≤≤≤≤≤........",
    "........................................",
    ".....»»»»»».................L...........",
    "..............«««««««.............ƒ.....",
    "...........X..............-----.........",
    "........................................",
    "..A...≤≤≤≤≤≤≤≤≤≤≤≤≤≤≤≤≤≤≤======≥≥≥≥≥≥≥.=",
    "&&&&..&&&&&&&&&&&&&&&&&&&&&&&&&&&&&&&&.&"
  ],
  "next" : [
    { "level": "1-Boss", "start": "A" }
  ]
}