{
  "special": "none",
  "width" : 40,
  "height" : 15,
  "scale" : 
    "0....5....0....5....",
  "map" : [
    "........********##***.............O....©",
    "................##***..................©",
    ".........W..........;..................©",
    "..........w.........;.......≤≤≤≤≤≤≤....©",
    ".................A..;..................©",
    "............è...¬¬¬¬¬..................©",
    "......................H................©",
    "+.....................----.............©",
    "+.............................H........©",
    ".....S...............................|.©",
    ".................#########...........@.©",
    ".....+++.........#########....{0.....©©©",
    ".....+++◊........###$$$!!!.............©",
    ".........©©©©>>©©©©[.]©©©©©»»»»»»»»»©©<©",
    ".........©©©©©©©••©...©•••©©©©©©©©©©©•••"
  ],
  "next" : [
    { "level": "test", "start": "A" }
  ]
}