{
  "special": "none",
  "width" : 107,
  "height" : 15,
  "scale" : 
    "0....*....@....*....@....*....@....*....@....*....5....*....@....*....@....*....@....*....@....*....0....*.",
  "map" : [
    "•••••••••••••••••••••••••••••©........©••••••••••••••••••••••••©©©©................................©•••••••",
    "••••••••••••••••©©©©©©©©©©©©©©........©©•••••••••••••••••••••••©O©©................................©©©•••••",
    "••••••••••©©©©©©©......................©©©©••••••••••••••••••••©###...F.......$....f1................©©••••",
    "••••••••©©©..u............F1........P..!!!©•••••••••••••••••••©©............-]©[.............F........©©•••",
    "••••••••©............P.............]©©©©©©©•••••••••••••©©©©©©©...............©.........$..............©©••",
    "••©©©©©©©.......f....#..............©••••••••••••••••••©©...+++...............©....©©©©©©...............©••",
    "•©©...+++............$.......¥¥.....©•••••••••••••••••©©....◊++.......©©.....©©......©©•©...............©••",
    "•©....+++............#....-]©©©©....©©••••••••••••••••©.....+++.......©$........f1...!©•©...............©••",
    "•©.A..◊++......-]©©©©©©.....©••©©...T©©©©©©©©©©©©©©©©©©.....+++.......©©©[.........©©©©•©...............©••",
    "•©©©©©©©©©[-.....©••••©¶¶¶¶¶©•••©©...T©©©©©©©©©©©©©©©©....©©©©©©©©.................©••••©.......|.......©••",
    "•••••••••©¶¶¶¶¶¶¶©••••©©©©©©©••••©©.......................©©©••••©..............©©©©••••©.......@.......©••",
    "•••••••••©©©©©©©©©•••••©©©©©••••••©©©©©©...................T©••••©©©..¥¥¥¥..©©©©©•••••••©¶¶¶¶¶¶¶©¶¶¶¶¶¶¶©••",
    "••••••••••©©©©©©©••••••••••••••••••••••©©©¶¶©©¶¶©¶©¶¶©©©©©©©©••••••©©©©©©©©©©•••••••••••©©©©©©©©©©©©©©©©©••",
    "•••••••••••••••••••••••••••••••••••••••••©©©©©©©©©©©©©•••••••••••••••••••••••••••••••••••©©©©©©©©©©©©©©©•••",
    "••••••••••••••••••••••••••••••••••••••••••©©©©©©©©©©©•••••••••••••••••••••••••••••••••••••©©©©©©©©©©©©©••••"
  ],
  "next" : [
    { "level": "4-4", "start": "A" }
  ]
}