{
  "special": "none",
  "width" : 100,
  "height" : 15,
  "scale" : 
    "0....*....1....*....2....*....3....*....4....*....5....*....6....*....7....*....8....*....9....*....",
  "map" : [
    "&&&&&&&&&&&&&&&&&&&&&&&&&&&&&&&&&&&&&&&&&&&&&&&&&&&&&&&&&&&&&&&&&&&&&&&&&&&&&&&&&...................",
    "&&&&&&&&&&&&&&&&&&&&&&&&&&&&&&&&&&&&&&&&&&&&&&&&&&&&&&&&&&&&&&&&&&&&&&&&&&&&&&&&&...................",
    "&&&&&&&&&&&&&&&&&&&&&&&&&&&&&&&&&&&&&&&&&&&&&&&&&&&&&&&&&&&&&&&&&&&&&&&&&&&&&&&&&.............L..|..",
    "&&&&&&&&......................................&&&&&&&&&&&&&&&&&&&&...........£¿&&................@..",
    "&&&&&&&&......................................&&&&&&&&&&&&&&&&&&&&...........£¿&&......≤≤≤≤≤≤///////",
    "&&&&&&.............................................&&&&&&..................////&&...............&&&&",
    "&&&&&&..................................¥¥.........&&&&&&...........L..........&&///............&&&&",
    "&&.....................¥.......................................................&&&&&..............&&",
    "&&....................¥.¥..w.......................................////........&&&&&..............&&",
    "&&..A...¥¥¥........w...¥.........w.................¥.¥.¥.......................&&&&&≥≥≥≥≥.....¥¥..&&",
    "///////≤≤≤≤≤//.....................≥≥≥≥........................................&&&&&........≥≥≥≥..&&",
    "&&&&&&&&&&&&&&/......≤≤≤≤≤...≤≤≤...&&&&....//...............≤≤≤≤≤≤≤//////[--...&...&..............&&",
    "&&&&&&&&&&&&&&&///...&&&&&^^^&&&...¥¥&&....&&...............$$&&&&&&&&&&&....................¥¥...&&",
    "&&&&&&&&&&&&&&&&&&^^^&&&&&///&&&...¥¥&&....&&...≤≤≤≤≤≤≤≤≤≤≤≤&&&&&&&&&&&&&..≤≤≤≤≤≤≤≤≤≤≤≤≤≤≤≤≤≤≤≤...&&",
    "&&&&&&&&&&&&&&&&&&///&&&&&&&&&&&...//&&....&&...&&&&&&&&&&&&&&&&&&&&&&&&&..&&&&&&&&&&&&&&&&&&&&...&&"
  ],
  "next" : [
    { "level": "2-3", "start": "A" }
  ]
}