{
  "special": "snow",
  "width" : 106,
  "height" : 15,
  "scale" : 
    "0....-....1....-....2....-....3....-....4....-....5....-....6....-....7....-....8....-....9....-....0...",
  "map" : [
    "...................................................****...................***********............*********",
    "................................................P..****.?.................***********............*********",
    "................................................◊..****...................***********............*********",
    ".......................................W..◊+++++◊....**.......--]¬¬¬......**+++++++++............*********",
    "...........................¥..............◊.....◊....**t.........***..P.¥.**+.......+............*********",
    "..........................¥.¥........P....◊..?..#....**¬¬¬.......***¬¬¬.¥.**+.......¢...]¬¬¬.....*********",
    "....................P...............◊◊....◊.....◊....*****.}1....******.¥.**◊...W...+....***.....◊********",
    "............¥¥¥...P.◊...............◊◊....◊..O..◊....*****.......******.............+....***.....+********",
    "......¬¬¬+++++++++++++++++¬¬¬++++++++++++++++++++++++*****.......T*****.............+..¬¬***.....+********",
    "..A..¬***.................***........................*****..}0...¬*****++++++++++++++..*****++++++***...**",
    "¬¬¬¬¬****.................***.........S..........................******................*****+.......*.|.**",
    "*********¬...........¬...¬***¬...¡....................¥¥¥........******................*****+.......#.@.**",
    "**********.....¬.....*...*****...¬....¡¡¡..........¡¡¡¡¡¡¡¡¡.....******................*****++++++++++++**",
    "**********...^^*^^^..*...*****...*....¬¬¬..¡^.^¡...¬¬¬¬¬¬¬¬¬.....******................*****............**",
    "**********...¬¬*¬¬¬..*...*****...*....***..¬¬.¬¬...*********.....******................*****............**" 
  ],
  "next" : [
    { "level": "3-5", "start": "A" }
  ]
}