{
  "special": "normal",
  "width" : 96,
  "height" : 41,
  "scale" : 
    "0....:....1....:....2....:....3....:....4....:....5....:....6....:....7....:....8....:....9....:....0....:",
  "map" : [
    "••©...©••©..............©••••••••••••••••••••••••••••••••••••••••©••©.................©•••©•••••",
    "••©.A.©••©..............©••••••••••••••••••••••••••••••••••••••••©©©©.................©©©©©•••••",
    "••©...©••©.......H1.....©•••••••••©©©©©©©©©©©©©••••••••••••••••©©©........................©•••••",
    "••©...©••©?.............©•••••••©©©...........©••••••••••••••••©..........................©©©©©©",
    "••©...©••©©©...........◊©©©©©©©©©.............©©©©©©©©©©©©©©©©©©...........................©••••",
    "••©...©••••©...]©©©©++++........................®®®®®®®®®®®®®®..............¥¥¥............©••••",
    "••©...©©©••©¥...©••©++++..¥¥....................©©©©©©©©©©©©©©...........¥.......¥.......-]©©©••",
    "••©.....©©©©[-..©••©©>>©©©©©..¥¥................##..#..#..####.........¥....©©©....¥.........©••",
    "••©............¥©•••©©©©•••©©©©©..¥¥¥...........##.P#.P#.P####..............©•©©.............©••",
    "••©©©©........¥¥©••••••••••••••©©©©©©©>>©©©©©©©©©©©©©©©©©©©©©©©©©©©©©©©©©<<©©••©©[-...¥....-]©••",
    "•••••©......¥©©©©••••••••••••••••••••©©©©••••••••••••••••••••••••••••©©©©©©©©©©©©............©••",
    "•••••©©©©©©©©©•••••©©©©©©©©©©©©©©©©••••••••••••••••••••••••••••••••©©©©.................¥....©••",
    "•••••••••••••••••©©©..............©©©©©©©©©©©©©©©©©©©©©©©©©©©©©©©©©©........................]©••",
    "•••••••••••••©©©©©.............................######...######...............................©••",
    "••••••••••••©©.................................######.à.######...............................©••",
    "••••••••••••©..................H1...........--]©©©©©©©©©©©©©©©..........................©©<<©©••",
    "••••••••••••©....¥¥............................©•••••••••••••©..........................©©©©©•••",
    "©©©©©©••••••©©>>©©©©[-........¥...¥............©•••••••••••••©....................©©¶¶¶¶©•••••••",
    "•••••©•••••••©©©©©©©..........-----............©•••••••••••••©....................©©©©©©©•••••••",
    "•••••©©©©©©©©©©................................©©©©©©©©©©©©©©©..............©©¶¶¶¶©•••••••••••••",
    "•••••©.........................................#.............#..¥¥¥.........©©©©©©©•••••••••••••",
    "©©©©©©............................©©©©©©©©©<<©©©[.-.-.-.-.-.]©©©©©©©©<<<<<©©©•••••••••••••••••••",
    "•••©..............................©•••••••©©©©•©¶¶¶¶¶¶¶¶¶¶¶¶¶©••••••©©©©©©©•••••••••••••••••••••",
    "•••©...........---]©©©©©©©©©©©©...©••••••••••••©©©©©©©©©©©©©©©••••••••••••••••••••••••••••••••••",
    "•••©...............©••••••••••©¶¶¶©•••••••••••••••••••••••••••••••••••••••••••••••••••••••••••••",
    "•••©©>>©©©[-.......©©©••••••••©©©©©•••••••••••••••••••••••••••••••••••••••••••••••••••••••••••••",
    "••••©©©©•©......f...©©•••••••••••••••••••••••••••••••••••••••••••©©©©©©©©©©©©©©©©©©©©©©©©©©©••••",
    "•••••••••©...........©©•••••••••••••••••••••••••••••••••••••••©©©©....................◊++++©©•••",
    "•••••••••©©©©.........©©©©••••••©©©©©©©©©©©©©©©©©©©©©©©©©©©©©©©.......................◊+++++©©••",
    "©©©©©©©••©••©.....f1.....©©••••©©.....................................................◊++++++©••",
    "••••••©••©••©.............©©••©©.......¥¥¥..................................¥¥¥.......◊++++++©••",
    "••••••©©©©©©©©©©©..........©©©©...........................¥¥¥.........................◊++++++©••",
    "••••••©•••••••••©..........####..................................................]©©©©©©.....©••",
    "••••••©•••••••••©..........####...................................................©••©©©..|..©••",
    "••••••©•••••••••©©©©©>>©©©©©©©©©©©[.............................]©©>>©©[..........©••©.º..@..©••",
    "••••••©•••••••••©•••©©©©•••••••••©............]©©>>©©[............©©©©............©••©.©©©©©]©••",
    "••••••©©©©©©©©©©©••••••••••••••••©..............©©©©...............©©.............©••©..|....©••",
    "•••••••••••©•••••••••••••••••••••©...............©©................©©.............©••©..@.B..©••",
    "•••••••••••©•••••••••••••••••••••©...............©©................©©.............©••©©©©©©©©©••",
    "•••••••••••©•••••••••••••••••••••©...............©©................©©.............©•••••••••••••",
    "•••••••••••©•••••••••••••••••••••©...............©©................©©.............©•••••••••••••"
  ],
  "next" : [
    { "level": "4-A", "start": "A" },
    { "level": "4-4", "start": "A" }
  ]
}