{
  "special": "magma_updown",
  "width" : 136,
  "height" : 15,
  "scale" : 
    "0....*....1....*....2....*....3....*....4....*....5....*....6....*....7....*....8....*....9....*....0....*....1....*....2....*....3....*..",
  "map" : [
    "•••••••••©.........©••••©.....................................©©©©©•••©.........©••©©©©©©©•••••••••••••••••••••••••••••••••••••©...©••••",
    "•••••••••©.........©••••©.....................................◊+++©©©•©.........©•©©.....©©•••••••••••••••••••••••••••••••••••©©...©©•••",
    "•••©©©©©•©...¥¥....©••••©..............f............¥?¥..........+++©•©..¥¥O¥¥.◊©•©..¥¥...©©••••••••••••••••••••••••••••••••••©..|..©•••",
    "••©©...©©©..¥..¥...©©••©©...........$..............................+©©©[]©©©©©++©©©.¥..¥...©••••••••••••••••••••••••••••••••••©..@..©•••",
    "••©.....©...........©••©...P.......##.............f..........F1....+.....©©................©•••••••••••••••••••••••©©©©©©©©©©©©[---]©•••",
    "••©..A..#...........©••©.......]©©©©©[................P............+.....©©................©••••••••••••••••••••©©©©.............¥..©•••",
    "••©©©©©©©©©©©..)....©©©©..)......©©•©....)....).....)....).......]©©©©©©©©©.]©©©©©©©©©.)...©•••••••••••••••••••©©................¥..©•••",
    "•••••••••••©©...................¥¥©•©.............................©•©©©©©©©..©©©©••••©.....©©•••••••••••••••••©©.........¥¥¥.....¥..©•••",
    "••••••••••©©.........¥¥.........¥¥©•©.......¥¥....................©•©...##....!!©•••©©......©©•••••••••••••••©©.....................©•••",
    "••••••••••©¥¥.................]©©©©•©............................]©•©.]©©©©©©©©©©••©©........©©©©©©©©©©©©©©©©©......................©•••",
    "••••••••••©¥¥..................©••••©.............................©©©..©•••••••••••©..................########..................)...©•••",
    "••••••••••©¥¥......]©©©©[......©••••©..............................#...©•••••••••••©.......©©©©>>>>©©©©©©©©©©©©©©©©[................©•••",
    "••••••••••©©©[......©••©.......©••••©.........................-]©©©©©©©©•••••••••••©.......©••©©©©©©••••••••••••••©.................©•••",
    "••••••••••••©.......©••©.......©••••©...........................©••••••••••••••••••©.......©••••••••••••••••••••••©.................©•••",
    "••••••••••••©.......©••©.......©••••©...........................©••••••••••••••••••©.......©••••••••••••••••••••••©.................©•••"
  ],
  "next" : [
    { "level": "4-5", "start": "A" }
  ]
}