{
  "special": "none",
  "width" : 114,
  "height" : 15,
  "scale" : 
    "0....*....1....*....2....*....3....*....4....*....5....*....6....*....7....*....8....*....9....*....0....*....1....*",
  "map" : [
    "&&&&&&&&&&&&&&&&&&&&&&&&&&&&&&&&&&&&&&&&&&&&&&&&&&&&&&&&&&&&&&&&&&&&&&&&&&&&&&&...&&&&&&&&&&&&&&&&&&&&&&........&&",
    "&&&&&&&&&&&&&&&&&&&&&&&&&&&&&&&&&&&&&&&&&&&&&&&&&..........&&&&.¥.............&.ì.&&&&&&&&&&&&&&&&&&&&&&........&&",
    "&&&&&&&&&&&&&&&&&&&&&&&&&&&&&&&&&&&&&&&&&&&&&&&&&........?.&&&&¥.¥..............ø.&&&&&&&&&&&&&&&&&&&&&&........&&",
    "................+........+........+...................f1...&&&&.¥........f..../...................&&&&&&....|...&&",
    "................+...¥¥...ø...¥¥...ø........//...........///&&&&///............&≥≥≥≥≥≥≥≥≥≥≥≥≥≥≥≥≥≥.&&&&&&....@...&&",
    "................ø........ø........ø........ƒ&...........&&......&&............&&&&&&&&&&&&&&&&&&&.&&&&&&..////[]&&",
    "................ø........ø........+.....///&&[---]//....&&..¥¥..&&....//......&&......&&..............&&..&.|...&&",
    ".A..............ø........+........+............¥..&&....&&......&&....&&......ƒ&......&&.........¥....&&..º.@.B.&&",
    "////........../////[--]/////[--]/////.........¥.¥.&&..//&&..//..&&//..&&//..-]&&..//..&&.....f1.¥.¥...&&[]//////&&",
    "&&&&/.....e8..&&&&&.e8.&&&&&.e7.&&&&&..........¥.+&&..ø............ø..&&&&........&&......................&&&&&&&&",
    "&&&&&/........&&&!!....$#$#$....#$#$#........-]///&ƒ..ø............ø..ƒ&&ƒ........&&......................!&&&&&&&",
    "////////////////////////////////////////e3.....&&&&&///[----------]///&&&&[------]&&[--]///////[...]//////&&&&&&&&",
    "&&&&&&&&&&&&&&&&&&&&&&&&&&&&&&&&&&&&&&&&.......&&&&&&&&e2..........&&&&&&&............e3&&&&&&&.....&&&&&&&&&&&&&&",
    "&&&&&&&&&&&&&&&&&&&&&&&&&&&&&&&&&&&&&&&&≤≤≤≤...&&&&&&&&............&&&&&&&..............&&&&&&&.≤≤≤.&&&&&&&&&&&&&&",
    "&&&&&&&&&&&&&&&&&&&&&&&&&&&&&&&&&&&&&&&&&&&&...&&&&&&&&≥≥≥≥≥≥≥≥≥≥≥≥&&&&&&&≤≤≤≤≤≤≤≤≤≤≤≤≤≤&&&&&&&.&&&.&&&&&&&&&&&&&&"
  ],
  "next" : [
    { "level": "2-A", "start": "A" },
    { "level": "2-5", "start": "A" }
  ]
}