{
  "special": "normal",
  "width" : 88,
  "height" : 32,
  "scale" : 
    "0....:....1....:....2....:....3....:....4....:....5....:....6....:....7....:....8....:....9....:....0....:",
  "map" : [
    "••©...........................................©••••••••••••••••••©......................",
    "••©...........................................©••••••••••••••••••©......................",
    "••©...........................................©••••••••••••••••••©......................",
    "••©...........................................©©©••••••••••••••©©©......................",
    "••©......................◊......................©••••••••••••••©..........¥¥¥¥..........",
    "••©....................+++......................©©©©©©©©©©©©©©©©......¥¥................",
    "••©...............¥¥..++++......................###..#..#..#####....¥.....©©©©..........",
    "••©.............]©©©©+++++.....¥¥¥¥¥............###.P#.P#.P#####..........©••©©.........",
    "••©....$.A.$.....©••©©>>>©©©©©©©©©©©©©©©©>>>©©©©©©©©©©©©©©©©©©©©©©©©©©©<<©©•••©©........",
    "••©....©©©©©.....©•••©©©©©••••••••••••••©©©©©•••••••••••••••••••••••••©©©©••••••••••••••",
    "••©¶¶¶¶©•••©¶¶¶¶¶©••••••••••••••••••••••••••••••••••••••••••••••••••••••••••••••••••••••",
    "••©©©©©©•••©©©©©©©••••••••••••••••••••••••••••••••••••••••••••••••••••••••••••••••••••••",
    "••••••••••••••••••••••••••••••••••••••••••••••••••••••••••••••••••••••••••••••••••••••••",
    "••••••••••••••••••••••••••••••••••••••••••••••••••••••••••••••••••••••••••••••••••••••••",
    "••••••••••••••••••••••••••••••••••••••••••••••••••••••••••••••••••••••••••••••••••••••••",
    "••••••••••••••••••••••••••••••••••••••••••••••••••••••••••••••••••••••••••••••••••••••••",
    "••••••••••••••••••••••••••••••••••••••••••••••••••••••••••••••••••••••••••••••••••••••••",
    "••••••••••••••••••••••••••••••••••••••••••••••••••••••••••••••••••••••••••••••••••••••••",
    "••••••••••••••••••••••••••••••••••••••••••••••••••••••••••••••••••••••••••••••••••••••••",
    "••••••••••••••••••••••••••••••••••••••••••••••••••••••••••••••••••••••••••••••••••••••••",
    "••••••••••••••••••••••••••••••••••••••••••••••••••••••••••••••••••••••••••••••••••••••••",
    "••••••••••••••••••••••••••••••••••••••••••••••••••••••••••••••••••••••••••••••••••••••••",
    "••••••••••••••••••••••••••••••••••••••••••••••••••••••••••••••••••••••••••••••••••••••••",
    "••••••••••••••••••••••••••••••••••••••••••••••••••••••••••••••••••••••••••••••••••••••••",
    "••••••••••••••••••••••••••••••••••••••••••••••••••••••••••••••••••••••••••••••••••••••••",
    "••••••••••••••••••••••••••••••••••••••••••••••••••••••••••••••••••••••••••••••••••••••••",
    "••••••••••••••••••••••••••••••••••••••••••••••••••••••••••••••••••••••••••••••••••••••••",
    "••••••••••••••••••••••••••••••••••••••••••••••••••••••••••••••••••••••••••••••••••••••••",
    "••••••••••••••••••••••••••••••••••••••••••••••••••••••••••••••••••••••••••••••••••••••••",
    "••••••••••••••••••••••••••••••••••••••••••••••••••••••••••••••••••••••••••••••••••••••••",
    "••••••••••••••••••••••••••••••••••••••••••••••••••••••••••••••••••••••••••••••••••••••••",
    "••••••••••••••••••••••••••••••••••••••••••••••••••••••••••••••••••••••••••••••••••••••••"
  ],
  "next" : [
    { "level": "4-3", "start": "A" }
  ]
}