{
  "special": "none",
  "width" : 20,
  "height" : 36,
  "scale" : 
    "0....*....1....*....2....*....3....*....4....*....5....*....6....*....7....*....8....*....9....*....",
  "map" : [
    "&&&&&&&&&&&&&&&&&&&&",
    "&&&&&&&&&&&&&&&&&&&&",
    "&&&&&&&&&&&&&&&&&&&&",
    "&...ø..........&&&&&",
    "&...£..........&&&&&",
    "&...ø..............&",
    "&.A.ø.....¥........&",
    "&/////...¥.¥...f...&",
    "&&&&&&/...¥........&",
    "&&&&&&&/...........&",
    "&&&&&&&&/////......&",
    "&&&&&&&&&&&&&/.....&",
    "&&&&&&&&&&&&&&//..]&",
    "&&&&&&&&&&&&&&&&...&",
    "&&&&&&&&&&&&&&&&...&",
    "&?¥..........&&&..]&",
    "&¥¥.f........&&&...&",
    "&¥¥............ø...&",
    "&//.......f1...ø..]&",
    "&..............£...&",
    "&.....≥≥≥≥.....ø...&",
    "&.....&&&&...//////&",
    "&.....&&&&^^^&&&&&&&",
    "&[..//&&&&&&&&&&&&&&",
    "&...&&&&&&&&&&&&&&&&",
    "&...&&..............",
    "&[..&&..............",
    "&...&&........f1....",
    "&...ø..¥¥........f..",
    "&[..ø.¥.............",
    "&...ø.......++......",
    "&...£..../////....|.",
    "&/////...&&&&&....@.",
    "&&&&&&...&&&&&...///",
    "&&&&&&...&&&&&...&&&",
    "&&&&&&...&&&&&...&&&"
  ],
  "next" : [
    { "level": "2-4", "start": "A" }
  ]
}