{
  "special": "magma_flood",
  "width" : 36,
  "height" : 81,
  "scale" : 
    "0....5....0....5....0....5....0....5",
  "map" : [
    "••••••••••••••••••••••••••••••••••••",
    "••••••••••••••••••••••••••••••••••••",
    "••••••••••••••••••••••••••••••••••••",
    "•••©©©©©©©©©©©••••••••••••••••••••••",
    "••©©.........©©••••••••••••••©©©©©••",
    "••©..?..Y.....©•••••••••••••©©...©©•",
    "••©..|........©•••••••••••••©..?..©•",
    "••©..@........©•••••••••••••©..|..©•",
    "••©©©©©©©©....©•••••••••••••©..@..©•",
    "•••••••••©..¥.©•••••••••••••©.---.©•",
    "•••••••••©...…©•••••••••••••©.....©•",
    "•••••••••©....©•••••••••••••©.....©•",
    "•••••••••©.¥..©•••••••••••••©..…..©•",
    "•••••••••©…1..©•••©©©©©©©©©©©.....©•",
    "•••••••••©....©•••©.......®®®.....©•",
    "•••••••••©..¥.©•••©.©©©©©©©©©[-...©•",
    "•••••••••©...…©•••©.......©•©.....©•",
    "•••••••••©....©•••©©©©©©©.©•©...¥.©•",
    "•••••••••©.¥..©•••©######.©•©...….©•",
    "•••••••••©…1..©•••©.######©•©.....©•",
    "•••••••••©....©©©©©©©©©©©.©•©.¥...©•",
    "•••••••••©....#########...©•©.…1..©•",
    "•••••••••©©©©©©©©©©©©©©<<©©•©.....©•",
    "••••••••••••••••••••••©©©©••©..?..©•",
    "••••••••••••••••••••••••••••©.---.©•",
    "••••••••••••©©©©©©©©©©©•••••©.....©•",
    "••••••••©©©©©.........©©©©©©©.....©•",
    "•••••••©©.................◊+++++©©©•",
    "••••••©©..................◊++++©©•••",
    "•©©©©©©........¥¥.F.......◊+++©©••••",
    "•©..........¥¥............◊++©©•••••",
    "•©...................--]©©©©©©••••••",
    "•©.........................©••••••••",
    "•©©>©©©[--......H1.........©••••••••",
    "••©©©•©..................-]©©•••••••",
    "•••••©©.....................©©©©©©©•",
    "••©©©©.........-----........###...©•",
    "••©.........................###...©•",
    "••©.....................-]©©©©©©<©©•",
    "••©....-]©©...............©••••©©©••",
    "••©......©©©>>>©©©©©©.M...©•••••••••",
    "••©[-....©©©©©©©••••©.....©•••••••••",
    "••©........©©•••••••©©©©©©©•••••••••",
    "••©.........©©©©©©••••••••••••••••••",
    "••©...--.........©©•••••••••••••••••",
    "••©...............©©©©©•••••••••••••",
    "••©........F1......u..©•••••••••••••",
    "••©..--...............©©©©©©©©©•••••",
    "••©............??.......u.....©©••••",
    "••©............©©..............©©•••",
    "••©...©©©©[..........f1.........©©••",
    "••©¥?¥©••©.......................©••",
    "••©©©©©••©...]©©©©©©©............©••",
    "•••••••••©....©•••••©.....¥¥.....©••",
    "•••••••••©¶¶¶¶©•••••©..©©©©©.....©••",
    "•••••••••©©©©©©•••••©¶¶©•••©..--.©©•",
    "••••••••••••••••••••©©©©•©©©.....T©•",
    "••••••••••••••••••••••••©©.......©©•",
    "•••••••••••••••••••••©©©©....--..©••",
    "••••••••••••••••••••©©...........©••",
    "•••••••••••••••••••©©............©••",
    "••••••••••••••••••©©....¥¥....--.©••",
    "••••••••••••••©©©©©....]©©[......©••",
    "•••••••••••••©©..................©••",
    "•••••••©©©©©©©..............H1.-]©••",
    "••••©©©©............--...........©••",
    "•••©©............................©••",
    "••©©..................P...]©©©©©[©••",
    "••©...................#....©©©©©.©••",
    "••©..........M......P##....$$$$$.©••",
    "••©..............©©©©©©©©©©©©©©©©©••",
    "••©.........©©©©©©••••••••••••••••••",
    "••©!.....¥¥.©•••••••••••••••••••••••",
    "••©©©[-]©©©©©•••••••••••••••••••••••",
    "••••©...©•••••••••••••••••••••••••••",
    "••••©.A.©•••••••••••••••••••••••••••",
    "••••©[-]©•••••••••••••••••••••••••••",
    "••••©...©•••••••••••••••••••••••••••",
    "••••©...©•••••••••••••••••••••••••••",
    "••••©...©•••••••••••••••••••••••••••",
    "••••©...©•••••••••••••••••••••••••••",
    "••••©...©•••••••••••••••••••••••••••"
  ],
  "next" : [
    { "level": "4-Boss", "start": "A" },
    { "level": "4-Boss", "start": "A" }
  ]
}