{
  "special": "none",
  "width" : 20,
  "height" : 15,
  "scale" : 
    "0....5....0....5....",
  "map" : [
    "....................",
    "....................",
    "....................",
    "....................",
    "......¥¥¥¥..........",
    "......¥Y.¥..........",
    "......¥..¥..........",
    "......¥¥¥¥..........",
    ".....------.........",
    "................|...",
    "................@.P.",
    "%%%%%-%%%%%%%%+++++%",
    "*****.********%+++%*",
    "*A.††.*********%%%**",
    "********************"   
  ],
  "next" : [
    { "level": "1-Boss", "start": "A" }
  ]
}