{
  "special": "none",
  "width" : 92,
  "height" : 15,
  "scale" : 
    "0....5....0....5....0....5....0....5....0....5....0....5....0....5....0....5....0....5....0.",
  "map" : [
    "*********************************************************************.......................",
    "**********************************......*************************...........................",
    "*******~.................~********.?.......*******************~.............................",
    "*****~......................~~****P..........*************~~................................",
    "................................**%%%........**********.....................................",
    "............................P.........w....w.....#..........................................",
    "...A....S...................#....................$.............$.w.w.$.w.w.$...P............",
    "%%%%%%%..........S..........#.....S.....--..S....#..................S.S........+.......|..P.",
    "*******%%%%....#$..........#$#...................#............................+++......@..!.",
    "*****+*****%%%%%%[--------]%%%[----------------]%%%[----------------------.--]%%%%%%%+++++%%",
    "******+**********..........***..................***.................P.........*******%+++%**",
    "**++++++*********.....----]***[---------...----]***..P..S..------------------]********%%%***",
    "******+**********.......P..***^^^^..^...P..P..P^***$$$.....P....P........PPP..∆*************",
    "*****+***********^^^^%%%%%%***%%%%%%%%%%%%%%%^^%***%%%%%%%%%%%%%%%%%%%%%%%%%%%**************",
    "*****************%%%%************************%%*********************************************"
  ],
  "next" : [
    { "level": "1-B", "start": "A" },
    { "level": "1-Boss", "start": "A" }
  ]
}