{
  "special": "none",
  "width" : 139,
  "height" : 15,
  "scale" : 
    "0....*....@....*....@....*....@....*....@....*....5....*....@....*....@....*....@....*....@....*....0....*....@....*....@....*....@....*",
  "map" : [
    "•••©......©•••••••••••••••••••••••••••••••••••••••••••••••••••••••••©......©•••••©.....................................................©•••",
    "•••©......©••••••••••••••••••••••••••••••••••••••••••••••••••••©©©©©©......©•••••©............................................X........©•••",
    "•••©......©•••••••••••••••••••••••••©©©©©©©©©©©©©©©©©©©••••••••©...........©©©©©•©.................¥¥¥.................................©•••",
    "•••©......©©©•••••••••••••••••••••••©.................©©©©©©©©©©...............©•©..............¥¥..........................©©©©©©.....©•••",
    "•••©........©•••••••••••••••©©©©©©©©©........................√.................©•©........................+.................©••••©.....©•••",
    "•••©........©©©©©©©©©©©©©©©©©................................√.................©©©..........¥.............+............-]©©©©©©©©©.....©•••",
    "•••©..|...............√................¥¥¥...................+...........++................+++............+..............©•••••••©.....©•••",
    "•••©..@.A.............√.............¥¥.......................+...........++++..............+++............+..............©•••••••©.....©•••",
    "•••©©©©©©©©©©>>>©©©©©©+............................++++......++++++++++++++++++++++++++++++++++++++++++++++..............©•••••••©.....©•••",
    "••••••••••••©©©©©••••©+...................+++++++++++++..................................................................©•••••••©.....©•••",
    "•••••••••••••••••••••©+++++++++++++++++++++++++++++++++..................................................................©©©©©©©©©.....©•••",
    "•••••••••••••••••••••©..............................................................................................................|..©•••",
    "•••••••••••••••••••••©..............................................................................................................@..©•••",
    "•••••••••••••••••••••©©©©©>©©©©©©©©©©©©©©>©©©©©©©©©©©©©©>©©©©©©©©©©©©©>©©©©©©©©©©©©©©>©©©©©©©©©©©©©©>©©©©©©©©©©©©©©>©©©©©©©©©©©©©©©©©©©©•••",
    "•••••••••••••••••••••••••©©©••••••••••••©©©••••••••••••©©©•••••••••••©©©••••••••••••©©©••••••••••••©©©••••••••••••©©©••••••••••••••••••••••"
  ],
  "next" : [
    { "level": "4-A", "start": "A" },
    { "level": "4-A", "start": "A" }
  ]
}