{
  "special": "snow",
  "width" : 20,
  "height" : 69,
  "scale" : 
    "0....*....1....*....",
  "map" : [
    "....................",
    "....................",
    "....................",
    "..............¥X.¥..",
    "..............¥..¥..",
    "....................",
    "....................",
    "......Æ8............",
    "....................",
    "...¥................",
    "...=................",
    "....................",
    ".....¥..............",
    ".....=..............",
    "....................",
    "....................",
    "¬¬..................",
    "**..................",
    "*π..................",
    "**..................",
    "**..................",
    "*π..................",
    "**..................",
    "**................|.",
    "*π.............¥¥.@.",
    "**............-]¬¬¬¬",
    "**................**",
    "**..¥¥...........T**",
    "**....æ6..........**",
    "**................**",
    "**t...........¥¥..**",
    "**....Æ6..........**",
    "**................**",
    "**....¥¥.........T**",
    "**....æ6..........**",
    "**................**",
    "**...........¥¥...**",
    "**....Æ6..........**",
    "**................**",
    "**................**",
    "..............==..**",
    ".??...............**",
    "..................**",
    "¬¬¬[....=....==...**",
    "**................**",
    "**.....¥.¥........**",
    "**....¥.¥.¥...==..**",
    "**...............T**",
    "**................**",
    "**.......}1.......**",
    "**................**",
    "**.............¥¥.**",
    "**.===.........¥¥.**",
    "**................**",
    "**t..¥¥¥..........**",
    "**...===..==...==.**",
    "**................**",
    "**...........¥....**",
    "**..........===...**",
    "**................**",
    "**................**",
    "**..............-]**",
    "..................**",
    ".....¬¬......P....**",
    ".A..¬**.....}0....**",
    "¬¬¬¬***...........**",
    "*******...........**",
    "*******...........**",
    "*******...........**"
  ],
  "next" : [
    { "level": "3-4", "start": "A" }
  ]
}