{
  "special": "none",
  "width" : 95,
  "height" : 15,
  "scale" : 
    "0....5....0....5....0....5....0....5....0....5....0....5....0....5....0....5....0....5....0....",
  "map" : [
    "...................................********.........................****...............********",
    "...................................********..¥.....w..¥.............####.............P.********",
    "....................................*******.¥.¥.................-]%%%%%%%%...........$$********",
    ".........................¥..........*******.....P.....+...............****..--]%%..P.$!********",
    "...............................-...¥¥******..O..+..........--...........**.....**%%%%%%********",
    "........................---........¥¥******%%%%%%........................*%%.............******",
    "...A..............................--]*******...............w.......w......**..............*****",
    ".....................................*******............P.....---.......P.**.....w.............",
    "............¥¥........--]%%.............#...........P..#$#............-]%%**%.......w..........",
    "...........¥.............**$............#.........+++.............P.....#P?**...............|..",
    "%%%%%.........++++......$**%%[-.........#......P..+++%%%%%[--.....++....#.?**[--.......¥¥¥..@P.",
    "*****%........++++.....%%****......-]%%%%%%%%%%%%%%%%*****^^....^^++++++%%%**^^.......]%%%%+++%",
    "%%%%%%%%%[-]%%%%%%%%%%%******^^^^^^^^*********************%%^^^^%%%%%%%%*****%%^^....^^****%%%*",
    "*********^^^*****************%%%%%%%%***********************%%%%***************%%^^^^%%********",
    "*********%%%*********************************************************************%%%%**********"
  ],
  "next" : [
    { "level": "1-2", "start": "A" }
  ]
}