{
  "width" : 90,
  "height" : 15,
  "scale" : 
    "0....5....0....5....0....5....0....5....0....5....0....5....0....5....0....5....0....5....",
  "map" : [
    "..................................****.........................****...............********",
    "................¥¥¥...............****.¥.¥....w..¥.............####.............P.********",
    "...................................***..¥..................-]%%%%%%%%...........$$********",
    "................---.....¥..........***.¥.¥.P.....+...............****..--]%%..P.$$********",
    "..............................-...¥¥**.....+..........--...........**.....**%%%%%%********",
    ".......................---........¥¥**%%%%%%........................*%%.............******",
    "...A.............................--]***...............w.......w......**..............*****",
    "....................................***............P.....---.......P.**.....w.............",
    "...........¥¥.|......--]%%...........#.........P..#$#............-]%%**%.......w..........",
    "..........¥...@B........**$..........#.......+++.............P.....#.P**...............|..",
    "%%%%.........++++......$**%%[-.......#....P..+++%%%%%[--.....++....#¥¥**[--.......¥¥¥..@P.",
    "****%........++++.....%%****......-]%%%%%%%%%%%%*****^^....^^++++++%%%**^^.......]%%%%+++%",
    "%%%%%%%%[-]%%%%%%%%%%%******^^^^^^^^*****************%%^^^^%%%%%%%%*****%%^^^.....****%%%*",
    "********^^^*****************%%%%%%%%*******************%%%%***************%%%^^^^^********",
    "********%%%******************************************************************%%%%%********"
  ],
  "next" : [
    { "level": "1-1", "start": "A" },
    { "level": "1-A", "start": "A" }
  ]
}