{
  "special": "none",
  "width" : 40,
  "height" : 15,
  "scale" : 
    "0....5....0....5....",
  "map" : [
    "........********##***..................©",
    "................##***..................©",
    ".........W..........;..................©",
    "..........w.........;.......≤≤≤≤≤≤≤....©",
    ".................A..;..................©",
    "............è...¬¬¬¬¬..................©",
    ".......................................©",
    "+.....................----.............©",
    "+......................................©",
    ".....S..............O............+..#|.©",
    ".................########............@.©",
    ".....+++.........########..{0{0.M....©©©",
    ".....+++◊........###$$$!!............©.©",
    ".........©©>>©©©©©©[.]©©©©©©©©©©©©©©©©©©",
    ".........©©©©©©©••©...©•••©©©©©©©©©©©•••"
  ],
  "next" : [
    { "level": "test", "start": "A" }
  ]
}