{
  "special": "normal",
  "width" : 44,
  "height" : 45,
  "scale" : 
    "0....:....1....:....2....:....3....:....4....:....5....:....6....:....7....:....8....:....9....:....0....:",
  "map" : [
    "••••©.A.©•••••••••••••••••••••••••••••••••••",
    "••••©...©•••••••••••©©©©©©©©©©©©©©©©©©©©••••",
    "••••©...©•••••©©©©©©©..................©••••",
    "••••©...©•••••©.¥P.....................©••••",
    "••••©...©©©©©•©¥.¥.....................©••••",
    "••••©.......©•©.¥............H.........©••••",
    "••••©.......©©©[--.............¥¥©©©...©••••",
    "••••©..........................¥¥©•©[..©••••",
    "••••©.................-]©©©..©©©©©•©...©••••",
    "••••©©©©©©....M1........©•©¶¶©•••••©...©••••",
    "•••••••••©........©©©©©©©•©©©©•••••©..]©©•••",
    "•••••••••©©©©©©©©©©••••••••••©©©©©©©...©©•••",
    "•••••••••••••••••••••••••••••©t........$©•••",
    "•••••••••••••••••••••••••••••©©...©©©©©©©•••",
    "•••©©©©©••••••••••••••••••©©©©©...©©©©©©©•••",
    "•••©...©©•••••••••••••••••©!###........T©•••",
    "•••©....©©©©©©©©©©••••••••©©©©©©©©©©...©©•••",
    "•••©.............©©••••••••••••••••©...©••••",
    "•••©..............©©©©©©©©©©©©©©©©©©...©••••",
    "•••©..............................©©[..©••••",
    "•••©..©©©©©[H.....................++...©••••",
    "•••©¥.T©••©..................¥¥...++...©••••",
    "•••©¥.T©••©...¥¥....M.............++..©©••••",
    "•••©..©©••©©©©©©..M.........M.....+◊..©•••••",
    "••©©..©••••••••©....©©©©©.........©©©©©•••••",
    "••©t.¥©••••••••©©©©©©•••©...©©©©..©•••••••••",
    "••©t.¥©•••••••••••••••••©¶¶¶©••©¶¶©•••••••••",
    "••©©..©•••••••••••••••••©©©©©©©©©©©•••••••••",
    "•••©..©•••••••••••••••••••••••••••••••••••••",
    "•••©..©••©©©©©••••••••••••••••••••©©©©••••••",
    "•••©..©©•©...©••••••••••••••••••©©©uu©••••••",
    "•••©..◊©©©.O.©••••••••••••••••©©©uu..©©©©©••",
    "•••©..◊++++++©•••••••••©©©©©©©©uu........©••",
    "•••©..◊©©©...©••••••©©©©...............?.©••",
    "•••©...©•©...©©©©©©©©.u................|.©••",
    "•••©...©•©...©©.u....................P.@.©••",
    "•••©...©©©...©©.......¥....H.........©©©©©••",
    "•••©.........++.¥..................©©©••••••",
    "•••©.........++..................©©©••••••••",
    "•••©©©©©.....++....¥..M1©©©©©©©©©©••••••••••",
    "•••••••©©....◊+...©©©...©•••••••••••••••••••",
    "••••••••©©©©©©©M..©•©...©•••••••••••••••••••",
    "••••••••••••••©...©•©©©©©•••••••••••••••••••",
    "••••••••••••••©©©©©•••••••••••••••••••••••••",
    "••••••••••••••••••••••••••••••••••••••••••••"
  ],
  "next" : [
    { "level": "4-2", "start": "A" }
  ]
}