{
  "special": "none",
  "width" : 20,
  "height" : 15,
  "scale" : 
    "0....5....0....5....",
  "map" : [
    "&&&&&&&............&",
    "&....&&..X......è..&",
    "&.|................&",
    "&.@A.....//.....≥≥≥&",
    "&///.....&&........&",
    "&........&&.≥≥≥....&",
    "&........ƒ&........&",
    "&....////&&........&",
    "&....&..........≥≥.&",
    "&....º.............&",
    "&[--]&.............&",
    "............≤≤≤....&",
    "..{1...............&",
    ".....≥≥≥≥≥≥........&",
    "...................&"
  ],
  "next" : [
    { "level": "2-4", "start": "B" }
  ]
}