{
  "special": "none",
  "width" : 20,
  "height" : 32,
  "scale" : 
    "0....5....0....5....",
  "map" : [
    "&..................&",
    "&..................&",
    "&..................&",
    "&..................&",
    "&............Y...|.&",
    "&................@.&",
    "ƒ...........]//////&",
    "&..................&",
    "&..................&",
    "&.»»...............ƒ",
    "&............»»»»..&",
    "&..................&",
    "ƒ..................&",
    "&..»»»»............&",
    "&..................ƒ",
    "&...............»»»&",
    "&..................&",
    "&.........»».......&",
    "&..................&",
    "ƒ..................&",
    "&»»»...............&",
    "&&&&...............ƒ",
    "&&&&.........»»//-]&",
    "&&&&.........&&&&..&",
    "&&&&...............&",
    "&.................]&",
    "&.|................&",
    "ƒ.@A...............&",
    "&////»»»»»»»»»»////&",
    "&&&&&&&&&&&&&&&&&&&&",
    "&&&&&&&&&&&&&&&&&&&&",
    "&&&&&&&&&&&&&&&&&&&&"
  ],
  "next" : [
    { "level": "2-5", "start": "B" },
    { "level": "2-5", "start": "B" }
  ]
}