{
  "special": "none",
  "width" : 45,
  "height" : 15,
  "scale" : 
    "0....5....0....5....0....5....0....5....0....",
  "map" : [
    "&&&&&................*****...................",
    "&&&&&................*****...................",
    "&&&&&................*****...................",
    "&&&&&................*****...................",
    "&....................+++++...................",
    "&.............¥¥.....+++P+..............W....",
    "&.A..................+++++................|..",
    "&/////...............+++++................@..",
    "&&&&&&/..............+++++.............¬¬¬¬¬¬",
    "&&&&&&&///[-.........◊++++........--]¬¬******",
    "&&&&&&&&&&........-]¬¬¬¬¬¬¬[-........********",
    "&&&&&&&&&&..........*******..........********",
    "&&&&&&&&&&.......^^^*******......¥..]********",
    "&&&&&&&&&&.......¬¬¬*******......¬...********",
    "&&&&&&&&&&.......**********......*...********"
  ],
  "next" : [
    { "level": "3-2", "start": "A" }
  ]
}