{
  "special": "none",
  "width" : 20,
  "height" : 15,
  "scale" : 
    "0....5....0....5....",
  "map" : [
    "....................",
    "....................",
    "....................",
    "....................",
    "....................",
    "......¥¥¥...........",
    ".....?¥¥¥?..........",
    "......¥¥¥...........",
    "....-------.........",
    "................|...",
    "................@.P.",
    "%%%%%-%%%%%%%%+++++%",
    "*****.********%+++%*",
    "*A.øø.*********%%%**",
    "********************"   
  ],
  "next" : [
    { "level": "1-Boss", "start": "A" }
  ]
}