{
  "special": "none",
  "width" : 40,
  "height" : 15,
  "scale" : 
    "0....5....0....5....",
  "map" : [
    "&&&&&&&&&&&&&&&&&&&&&&&&&&&&&&&&&&&&&&&&",
    "&&&&&&&&&&&&&&&&##&&&&&&&&&&&&&&&&&&&&&&",
    "&&&&&&&&&&&&&&&&##&&&&&&&&&&&&&&&&&&&&&&",
    "........&&.................P............",
    "........................................",
    "............................S.P.........",
    "......{...{.............................",
    "..........----...W......≤≤≤≤≤≤≤≤........",
    "....................w.............w.....",
    ".....»»»»»»................P............",
    "..............«««««««..W................",
    "..........................-----.........",
    ".......................................%",
    "..A...≥≥≥≥≥≥≥≥≥≥≥≥≥≥≥≥≥≥≥≥=====≥≥≥≥≥≥≥≥≥",
    "&&&&&&&&&&&&&&&&&&&&&&&&&&&&&&&&&&&&&&&&"
  ],
  "next" : [
    { "level": "1-Boss", "start": "A" }
  ]
}