{
  "special": "none",
  "width" : 20,
  "height" : 15,
  "scale" : 
    "0....5....0....5....",
  "map" : [
    "*.......****.......*",
    "*.......****.......*",
    "*.......****..¥¥¥..*",
    "*.A..+..****..¥¥¥..*",
    "*%%%%%..****.......*",
    "******..****[%%%%%.*",
    "******...^^^#*****.*",
    "******...%%%.......*",
    "******...***[%%%...*",
    "******....^^#***...*",
    "******....%%.......*",
    "******....**[......*",
    "*S..**..........|..*",
    "*...**..........@..*",
    "*%%%**%%%%%%%%%%%%%*"    
  ],
  "next" : [
    { "level": "1-2", "start": "B" }
  ]
}