{
  "special": "magma_updown",
  "width" : 40,
  "height" : 15,
  "scale" : 
    "0....5....0....5....",
  "map" : [
    "........********##***..................©",
    "................##***..................©",
    ".........W..........;..................©",
    "..........w.........;.......≤≤≤≤≤≤≤....©",
    ".................A..;..................©",
    "............è...¬¬¬¬¬........F.........©",
    ".................................f.....©",
    "+.....................----.............©",
    "+......................................©",
    ".....S..............O............+..#|.©",
    ".................########............@.©",
    ".....+++.........########..{0{0......©©©",
    ".....+++◊........###$$$!!..............©",
    ".........©©©©©©©©©©[.]©©©©©»»»»»»»»»©©©©",
    ".........©©©©©©©••©...©•••©©©©©©©©©©©•••"
  ],
  "next" : [
    { "level": "test", "start": "A" }
  ]
}