{
  "special": "none",
  "width" : 130,
  "height" : 15,
  "scale" : 
    "0....*....1....*....2....*....3....*....4....*....5....*....6....*....7....*....8....*....9....*....0....*....1....*....2....*....3",
  "map" : [
    "&&&&&&&.......................................................................................................................&&&&",
    "&&&&&&&...........................................¥¥..........................................................................&&&&",
    "&&&&&&&...........¥.¥......................................................................L1.................................&&&&",
    "&&&&&&&......¥.¥....................L.......................................................|..B..............................&&&&",
    "&&&&&&&..............{2................................f........?...........................@.///.............................&&&&",
    "&&&&&&&.............................{3...........{2{2...f1.................................///&&&...............................&&",
    "&&&&&&&..............................................................................................................¥.......|..&&",
    "&&....ø.........{1.......................{1..........................{1..{3....{0....««««................¥..........¥........@..&&",
    "&&....ø....................≤≤≤≤≤≤≤.............................///[...........¥¥¥¥...&&&&...............¥..........¥......./////&&",
    "&&.A..ø....................&&&&&&&...........{0.............../&&&...........««««««..&&&&»»»»..........¥...................&&&&&&&",
    "&&//////[..{0..............&&&&&&&..≥≥≥≥...................///&&&&...........&&&&&&..&&&&&&&&..................»»».........&&&&&&&",
    "&&&&&&&&......≤≤≤.....¥¥¥..&&&&&&&..&&&&.......≤≤≤.........&&...&&[..........&&&&&&..&&&&&&&&...»»»»»».........&&&.........&&&&&&&",
    "&&&&&&&&......&&&.....≤≤≤..&&&&&&&..&&&&.......&&&..≥≥≥....&&........««««««..&&&&&&..&&&&&&&&...&&&&&&.........&&&.........&&&&&&&",
    "&&&&&&&&......&&&.....&&&..&&&&&&&..&&&&.......&&&..&&&....&&.O......&&&&&&..&&&&&&..&&&&&&&&...&&&&&&[-.....-]&&&[-.....-]&&&&&&&",
    "&&&&&&&&......&&&.....&&&..&&&&&&&..&&&&.......&&&..&&&....&&/////...&&&&&&..&&&&&&..&&&&&&&&...&&&&&&.........&&&.........&&&&&&&"
  ],
  "next" : [
    { "level": "2-Boss", "start": "A" },
    { "level": "2-B", "start": "A" }    
  ]
}