{
  "special": "snow",
  "width" : 50,
  "height" : 27,
  "scale" : 
    "0....5....0....5....0....5....0....5....0....5....0....5",
  "map" : [
    "..................................................",
    "..................................................",
    "............?.....................................",
    "...........¥.¥..............................¥.¥.¥.",
    ".............................................¥.¥..",
    "....................................¬¬¬¬¬¬..¥.¥.¥.",
    "...........¬¬¬H1...................¬******¬.......",
    "...........***....................¬********¬¬¬¬¬¬¬",
    "...........***....................****************",
    "...........***¬¬¬¬[.....¬¬¬¬¬.....****************",
    "..............****.....¬*****¬....****************",
    "...............***..-]¬*******....****************",
    "...............***....********....****************",
    "...............***....*******©....©***************",
    "................**...]*******©◊...©***************",
    "......................*******©++++©***************",
    ".....................P*******©++++©***************",
    ".....................]*******©++++©***************",
    "..............$$......*******©++++©***************",
    "............]¬¬¬¬.....*******©++++©***************",
    "...A.........****¬¬¬¬¬*******©++++©©©©©©©©©©©©©©**",
    ".........¬¬¬¬****************©+++++++++++++++++©**",
    "........¬********************©+++++++++++++++++©**",
    "¬¬+++¬¬¬*********************©©©©©©©©©©©©©..|..©**",
    "**¬¬¬************************************©..@..©**",
    "*****************************************©©©©©©©**",
    "*****************************************©©©©©©©**"
  ],
  "next" : [
    { "level": "4-2", "start": "A" }
  ]
}