{
  "special": "magma_updown",
  "width" : 66,
  "height" : 15,
  "scale" : 
    "0....*....1....*....2....*....3....*....4....*....5....*....6....*....7....*....8....*....9....*....0....*....1....*....2....*....3..",
  "map" : [
    "••©....................©••••••••••••••••••©.............©•••••••••",
    "••©....................©••••••••••••••©©©©©.............©•©©©©©•••",
    "••©................P...©••••••••••••••©.................©©©...©©••",
    "••©.A..............$...©••••••••••••©©©.........P........©..|..©••",
    "••©...............##...©••••••••••••©..........P#........º..@..©••",
    "••©....$$...]©©©©©©©...©©©©•••••••••©..........$$.....-]©©©©©©©©••",
    "••©©©©©©©....©©©©••©......©••©©©©©••©...]©©©©©©©©.......©•••••••••",
    "••••••••©.......©••©......©••©¥¥¥©••©....©••••••©.......©©©•••••••",
    "••••••••©.......©••©©©....©••©...©••©[-..©••©©©©©[--......©•••••••",
    "••••••••©©©©©¥.¥©••••©....©©©©...©©©©....©•©©..........¥¥?©•••••••",
    "••••••••••••©.¥.©••••©©...####...####....©•©.........-]©©©©•••••••",
    "••••••••••••©¥.¥©•••••©©©©©©©©©©©©©©©©©©©©•©.è.........©••••••••••",
    "••••••••••••©©©©©••••••••••••••••••••••••••©©©©[..©©...©••••••••••",
    "••••••••••••••••••••••••••••••••••••••••••••••©...©©...©••••••••••",
    "••••••••••••••••••••••••••••••••••••••••••••••©...©©...©••••••••••"
  ],
  "next" : [
    { "level": "4-6", "start": "A" }
  ]
}