{
  "special": "snow",
  "width" : 104,
  "height" : 15,
  "scale" : 
    "0....-....1....-....2....-....3....-....4....-....5....-....6....-....7....-....8....-....9....-....0...",
  "map" : [
    ".................................................****...................***********............*********",
    ".................................................****.?.................***********............*********",
    ".......................................W......P..****...................***********............*********",
    "..........................................◊++++..****.......--]¬¬¬......**+++++++++............*********",
    "...........................¥..............◊.¥.+..****t.........***..P.¥.**+.......+............*********",
    "..........................¥.¥........P....◊¥?¥+..****¬¬¬.......***¬¬¬.¥.**+.......¢...]¬¬¬.....*********",
    "....................P...............◊◊....◊S¥.+....*****.}1....******.¥.**◊...W...+....***.....◊********",
    "............¥¥¥...P.◊...............◊◊....◊...#....*****.......******.............+....***.....+********",
    "......¬¬¬+++++++++++++++++¬¬¬++++++++++++++++++++++*****.......T*****.............+..¬¬***.....+********",
    "..A..¬***.................***......................*****..}0...¬*****++++++++++++++..*****++++++***...**",
    "¬¬¬¬¬****.................***........S.........................******................*****+.......*.|.**",
    "*********¬...........¬...¬***¬...¡..................¥¥¥........******................*****+.......#.@.**",
    "**********.....¬.....*...*****...¬...¡¡¡.........¡¡¡¡¡¡¡¡¡.....******................*****++++++++++++**",
    "**********...^^*^^^..*...*****...*...¬¬¬...¡¡¡...¬¬¬¬¬¬¬¬¬.....******................*****............**",
    "**********...¬¬*¬¬¬..*...*****...*...***...¬¬¬...*********.....******................*****............**" 
  ],
  "next" : [
    { "level": "3-5", "start": "A" }
  ]
}