{
  "special": "boss",
  "width" : 41,
  "height" : 15,
  "scale" : 
    "0....5....0....5....0....5....0....5....",
  "map" : [
    "•••••••••••••••••••••©..................©",
    "•••••••••••••••••••••©..................©",
    "•••©©©©©©©©©©©©©©©©©©©..................©",
    "••©©.................;........Z....d....©",
    "••©..A...............;..................©",
    "••©..................;..................©",
    "••©..................;..........(2......©",
    "••©..................;..................©",
    "••©©©©©©©©©©©©©©©©©©©©..................©",
    "•••••••••••••••••••••©..................©",
    "•••©©©•••©©©•••©©©•••©.....(0...........©",
    "•••©¶©•••©¶©•••©¶©•••©..................©",
    "•••©©©•••©©©•••©©©•••©¶¶¶©©©©©©©©©©©©¶¶¶©",
    "•••••••••••••••••••••©©©©©••••••••••©©©©©",
    "•••••••••••••••••••••••••••••••••••••••••"   
  ],
  "next" : []
}