{
  "special": "magma_updown",
  "width" : 123,
  "height" : 15,
  "scale" : 
    "0....*....1....*....2....*....3....*....4....*....5....*....6....*....7....*....8....*....9....*....0....*....1....*....2....*",
  "map" : [
    "•••©....................©••••••••••••••••••©........©••••©...................................©©©©©••••©.........©••••••••••",
    "•••©....................©••••••••••••••©©©©©........©••••©...................................◊+++©©©••©.........©••••••••••",
    "•••©................P...©••••••••••••••©.......¥¥...©••••©...............f......¥...............+++©••©....O...◊©••••••••••",
    "•••©..A.............$...©••••••••••••©©©......¥..¥..©©©••©............#........¥.¥................+©©©©[]©©©©©++©••••••••••",
    "•••©...............##...©••••••••••••©................©••©...P....P..#$.........¥...........F1....+.¥?...©©.....•••••••••••",
    "•••©....$$...]©©©©©©©...©©©©•••••••••©................©••©.......]©©©©©[..........................+.?¥...©©.......•••••••••",
    "•••©©©©©©©....©©©©••©......©••©©©©©••©...]©©©©©..)....©••©..).....©©••©....)....¥..)....).......]©©©©©©©©©©.]©©©©••••••••••",
    "•••••••••©.......©••©......©••©¥¥¥©••©....©••©©.......©©©©.........©©•©........¥.¥...............©•©©©©©©©©..©•••••••••••••",
    "•••••••••©.......©••©©©....©••©...©••©[-..©•©©....................¥¥©•©.........¥................©•©....##...©•••••••••••••",
    "•••••••••©©©©©¥.¥©••••©....©©©©...©©©©....©•©¥¥........¥¥.........¥¥©•©.........................]©©©.]©©©©©©©©•••••••••••••",
    "•••••••••••••©.¥.©••••©©...####...####....©•©¥¥...................¥¥©•©...............................©••••••••••••••••••••",
    "•••••••••••••©¥.¥©•••••©©©©©©©©©©©©©©©©©©©©•©¥¥..................]©©©•©...............................©••••••••••••••••••••",
    "•••••••••••••©©©©©••••••••••••••••••••••••••©©©[.....]©©©©[.......©•••©......................-]©©©©©©©©••••••••••••••••••••",
    "••••••••••••••••••••••••••••••••••••••••••••••©.......©••©........©•••©........................©•••••••••••••••••••••••••••",
    "••••••••••••••••••••••••••••••••••••••••••••••©.......©••©........©•••©........................©•••••••••••••••••••••••••••"
  ],
  "next" : [
    { "level": "test", "start": "A" }
  ]
}