{
  "special": "none",
  "width" : 40,
  "height" : 27,
  "scale" : 
    "0....5....0....5....0....5....0....5....0....5....0....5....0....5....0....5....0....5....0....",
  "map" : [
    "...................................&&&&&",
    "...................................&&&&&",
    "................................à..&&&&&",
    "................................ø..&&&&&",
    "...................................&&&&&",
    "...................................&&&&&",
    ".................................S.&&&&&",
    "..........................]========&&&&&",
    "...........................&&&&&&&&&&&&&",
    "...........................&&&&&&&&&&&&&",
    "..........................]&&&&&&&&&&&&&",
    ".............................&&&&&&&&&&&",
    ".............................&&&&&&&&&&&",
    "........................{2...&&&&&&&&&&&",
    ".............................&&&&&&&&&&&",
    ".................¥¥..........&&&&&&&&&&&",
    ".............................&&&.....&&&",
    "...............................&..|..&&&",
    "...............................º..@..&&&",
    "...............e...-]===================",
    ".....................&&&&&&&&&&&&&&&&&&&",
    "..A............{1....&&&&&&&&&&&&&&&&&&&",
    "%%%%.................&&&&&&&&&&&&&&&&&&&",
    "****%%%[-..{0..........&&&&&&&&&&&&&&&&&",
    "******.................&&&&&&&&&&&&&&&&&",
    "*****..................&&&&&&&&&&&&&&&&&",
    "*****..................&&&&&&&&&&&&&&&&&"
  ],
  "next" : [
    { "level": "2-2", "start": "A" }
  ]
}