{
  "special": "none",
  "width" : 30,
  "height" : 46,
  "scale" : 
    "0....5....0....5....0....5....",
  "map" : [
    "***............***************",
    "***............***************",
    "**~.......S.|..***************",
    "*~..........@..***************",
    "*....-]%%%%%%%%***************",
    "*......***********************",
    "*¥¥....~~~~~~~~~**************",
    "*[-....S........~~~~~*********",
    "*...............S....~~~~~****",
    "*.P..+++++.S...............#!*",
    "*^^^^+++++....++++.........#$*",
    "*%%%%%%%%%%%%%%%%%%%%%[--]%%%*",
    "*********************~....~***",
    "*********************..ww..***",
    "*********************.-..-.***",
    "*********************......***",
    "*******************~~......~**",
    "*****************~~....--...~*",
    "***.......******~............*",
    "**....|....****~.......P.....*",
    "**....@.B..#.**........%%....*",
    "**.%%%%%%%%%...........~~....*",
    "**.*********........¥¥.......*",
    "**]***.##...........--.......*",
    "**.***.*[..................??*",
    "**.***.*.................-]%%*",
    "**]***.*......%%%[.........***",
    "**$^^..*.%%[-]***^^^^^...^^***",
    "*..%%..*.**...***%%%%%^^^%%***",
    "*.]**..*[**...********%%%*****",
    "*........**..]****************",
    "*........**...~~**************",
    "*%%%%%%%%**.....~~***~~~~~****",
    "***********[-.....~~~.....~***",
    "***********.....w..........~**",
    "***********...¥...¥.--......~*",
    "***********...-...-....w.....*",
    "***********.....-........-...*",
    "********~....................*",
    "*****~......¥¥¥......w.......*",
    "***~.......¥...¥.........+...*",
    "*$#...............++.....++..*",
    "*$#.A.............++^^^^^++^^*",
    "*%%%%%%%%%%.....++++%%%%%%%%%*",
    "***********^^^^^++++**********",
    "***********%%%%%%%%%**********",
    "******************************"
  ],
  "next" : [
    { "level": "1-A", "start": "A" },
    { "level": "1-3", "start": "A" }
  ]
}