{
  "special": "boss",
  "width" : 40,
  "height" : 15,
  "scale" : 
    "0....5....0....5....",
  "map" : [
    "........********##***..p...............*",
    "................##***..................*",
    ".........W..........;..................*",
    "..........w.........;..................*",
    "....◊++++...b....A..;..................*",
    "........+...è...¬¬¬¬¬..................*",
    "+++++++++...........*..................*",
    "+...........}0....b.*..................*",
    "++...............b..*..................*",
    ".....S......}2......*............R.....*",
    "....................*..................*",
    ".....+++....}0......*..................*",
    ".....+++◊...........*++++++++++++++++++*",
    "¬¬¬¬..¡¡¡¡¡¡¡¡¡¡¡¡¡¡*¬¬¬¬¬¬¬¬¬¬¬¬¬¬¬¬¬¬*",
    "****..¬¬¬¬¬¬¬¬¬¬¬¬¬¬********************"
  ],
  "next" : [
    { "level": "1-Boss", "start": "A" }
  ]
}