{
  "special": "boss",
  "width" : 45,
  "height" : 15,
  "scale" : 
    "0....:....1....:....2....:....3....:....4....",
  "map" : [
    "********.................;..................*",
    "********.................;..................*",
    "********.................;..................*",
    "********.................;......V...........*",
    "********.................;........Z.........*",
    "*.....++............¬¬¬¬¬¬..................*",
    "*.....++...........¬******..................*",
    "*.|...++........¬¬¬*******..................*",
    "*.@.B.◊+...A...¬**********....--......--....*",
    "*¬¬¬¬¬¬¬¬¬¬¬¬¬¬***********..................*",
    "**************************..--..........--..*",
    "**************************..................*",
    "**************************+^^^^^++++++^^^^^+*",
    "**************************¬¬¬¬¬¬¬¬¬¬¬¬¬¬¬¬¬¬*",
    "*********************************************"
  ],
  "next" : [
    { "level": "3-A", "start": "B" }
  ]
}